25 20
 ^^^^^^^^^^^
^,,,,,,G,,,,^  ^^^^^^^^^^
^,@,,,,,,,,,^^^,,,,,,,,,^
^,,,,,,,,,,,,,,,,,,,,,,,^
^^^^^^^^^^^^^^,,,,,,,,,,^
             ^,a,,,,,,,a^
            ^,,,,,,w,,,,^
  ^^^^^^^^^^^^,a,,,,,,,a^
  ^,,,,f,,,,^,,,,,,,,,,,^
  ^,~~~~~~~,^^,a,,,,,,,a^
  ^,~~~~~~~,^,,,,,,w,,,,^
  ^,~~~~~~~,^^.a,,,,,,,a^
  ^c^^^^^^^c^^^^^^,,,,^^^
  ^,,,,,,,,,,,,,,,,,,,,,^
  ^,,,,,,,,,,,,,,,,,,,,,^
  ^,,,,,,,,,,,,,,,,,,,,,^
  ^,,,,,,,,,,,,,,,,,,,,,^
  ^,,,,,,,,,,,,,,,,,,,,,^
  ^,,,,,,,,,,,,,,,,,,,,,^
  ^^^^^^^^^^^^^^^^^^^^^^^
